а	ah	                                 
ә	ae
б	b
в	v
г	g
ғ	gh
д	dh
е	eh
ё	yo
ж	zh
з	z
и	iy
й	j
к	k
қ	kk
л	l
м	m
н	n
ң	ng
о	o
ө	er
п	p
р	r
с	s
т	t
у	uh
ұ	uw
ү	ux
ф	f
х	kh
һ	hh
ц	ts
ч	ch
ш	sh
щ	shch
ъ	hs
ы	y
і	axr
ь	ss
э	e
ю	yu
я	ya
